↑N  ┌────┐  ┌─┐ ┌─┬  ┌─┐  
    └──┐ │  └─┘ │ ├  │ │  
    ┌──┘ │  ┌───┘ ├  └─┘  
    └────┘  └─────┘☕      
     ┌─ ─┐   ▯  ┌─┐  ┌────
    ┌┘ ≋    ┌───┘ │       
    └────┘  └─────┘       
──┐ ┌────┬  ┌───┐    ┌────
  │ │    ├  │   └─┤  │    
──┘ └────┴  └─────┘  └────
            ┌──┐     ┌────
                     │    
            └──┘     │    